____________________
____________________
__O_____________O___
___O___OO_OO___O____
__O___O_OOO_O___O___
___O__O_____O__O____
__O___O_____O___O___
___O___O___O___O____
__O_____O_O_____O___
_________O__________
____________________
____________________
____________________
____________________
____________________
____________________
____________________
____________________
____________________
