____________________
____________________
____________________
______O_O_O_O_O_____
_____O_O_O_O_O_O____
______O_O_O_O_O_____
_____O_O_O_O_O_O____
______O_O_O_O_O_____
____________________
____________________
____________________
____________________
____________________
____________________
____________________
____________________
____________________
____________________
____________________
____________________
