____________________
____________________
____________________
____________________
____________________
____________________
____________________
____________________
___________________G
___C__________C____O
___O__________O____O
__OOO________OOO___O
P_OOO_E__E___OOOEEEO
OOOOOOOOOOOOOOOOOOOO
____________________
____________________
____________________
____________________
____________________
____________________
