___OG__________O____
___OO______E___O____
___O_______OOOOO____
___O___________O____
___O___________O____
___O_E_________O____
___OOOOO_______O____
___O___________O____
___O_______E___O____
___O_______OOOOO____
___OCCCC___CCCCO____
___OCCCC___CCCCO____
___OOOOO___CCCCO____
___O_______CCCCO____
___OP______CCCCO____
OOOOOOOOOOOOOOOOOOOO
____________________
____________________
____________________
____________________
