____________________
____________________
____________________
____________________
____________________
____________________
____________________
____________________
____________________
____________________
____________________
____________________
_P__CCC_E___CCC___G_
OOOOOOOOOOOOOOOOOOOO
____________________
____________________
____________________
____________________
____________________
____________________
